  _   _      _ _         __        __         _     _ _ 
 | | | |    | | |        \ \      / /        | |   | | |
 | |_| | ___| | | ___     \ \ /\ / /__  _ __ | | __| | |
 |  _  |/ _ \ | |/ _ \     \ V  V / _ \| '_ \| |/ _` | |
 | | | |  __/ | | (_) |     \_/\_/ (_) | | | | | (_| |_|
 \_| |_/\___|_|_|\___( )                     |_| \__,_(_)
                    |/                                  
"""

print(ascii_hello_world)